СЕМЬЯ 家庭 jiātíng - семья
СЕМЬЯ 父母 fùmǔ - родители
СЕМЬЯ 爸爸 bàba - отец
СЕМЬЯ 妈妈 māma - мама
СЕМЬЯ 儿子 érzi - сын
СЕМЬЯ 女儿 nǚ'ér - дочь
СЕМЬЯ 祖父 zǔfù - дед
СЕМЬЯ 祖母 zǔmǔ - бабушка
СЕМЬЯ 哥哥 gēgē - брат
СЕМЬЯ 姐姐 jiějiě - сестра
ЧЕЛОВЕК 人 rén - человек
ЧЕЛОВЕК 男子 nánzǐ - мужчина
ЧЕЛОВЕК 丈夫 zhàngfū - муж
ЧЕЛОВЕК 女子 nǚzǐ - женщина
ЧЕЛОВЕК 妻子 qīzi - жена
ЧЕЛОВЕК 孩子 háizi - ребенок
ЧЕЛОВЕК 男孩 nánhái - мальчик
ЧЕЛОВЕК 女孩 nǚhái - девочка
ЧЕЛОВЕК 朋友 péngyǒu - друг
ЧЕЛОВЕК 客人 kèrén - гость
РАБОТА 工作 gōngzuò - РАБОТА
РАБОТА 老师 lǎoshī - учитель
РАБОТА 司机 sījī - водитель
РАБОТА 工人 gōngrén - рабочий
РАБОТА 工程师 gōngchéngshī - инженер
РАБОТА 医生 yīshēng - врач
РАБОТА 护士 hùshì - медсестра
РАБОТА 售货员 shòuhuòyuán - продавец
РАБОТА 会计 kuàijì - бухгалтер
РАБОТА 画家 huàjiā - художник
РАБОТА 学生 xuéshēng - студент, ученик
ЖИВОТНОЕ 动物 dòngwù - ЖИВОТНОЕ
ЖИВОТНОЕ 猫 māo - кошка
ЖИВОТНОЕ 狗 gǒu - собака
ЖИВОТНОЕ 鸟 niǎo - птица
ГОРОД 市 shì - ГОРОД
ГОРОД 学校 xuéxiào - школа
ГОРОД 剧院 jùyuàn - театр
ГОРОД 街 jiē - улица
ГОРОД 广场 guǎngchǎng - площадь
ГОРОД 地点 dìdiǎn - место
ГОРОД 房子 fángzi - дом, здание
ГОРОД 家 jiā - дом в котором ты живешь 
ГОРОД 教会 jiàohuì - церковь
ГОРОД 河 hé - река
ГОРОД 餐厅 cāntīng - ресторан
ГОРОД 酒店 jiǔdiàn - гостиница
ГОРОД 园 yuán - сад
ГОРОД 公园 gōngyuán - парк
ГОРОД 银行 yínháng - банк
ГОРОД 车站 chēzhàn - остановка, вокзал, станция
ГОРОД 电影院 diànyǐngyuàn - кинотеатр
ГОРОД 桥 qiáo - мост
ГОРОД 路口 lùkǒu - перекресток
ГОРОД 森林 sēnlín - лес
ГОРОД 医院 yīyuàn - больница
ГОРОД 市场 shìchǎng - рынок
ГОРОД 警察 jǐngchá - полиция
ГОРОД 邮局 yóujú - почта
ГОРОД 中心 zhōngxīn - центр
ГОРОД 商店 shāngdiàn - магазин
ГОРОД 山 shān - гора
КВАРТИРА 套间 tàojiān - КВАРТИРА
КВАРТИРА 厨房 chúfáng - кухня
КВАРТИРА 阳台 yángtái - балкон
КВАРТИРА 浴室 yùshì - ванная
КВАРТИРА 淋浴 línyù - душ
КВАРТИРА 厕所 cèsuǒ - туалет
КВАРТИРА 地板 dìbǎn - пол
КВАРТИРА 天花板 tiānhuābǎn - потолок
КВАРТИРА 层 céng - этаж
КВАРТИРА 走廊 zǒuláng - коридор
КВАРТИРА 卧室 wòshì - спальня
КВАРТИРА 客厅 kètīng - зал
КВАРТИРА 门 mén - дверь
КВАРТИРА 窗户 chuānghu - окно
КВАРТИРА 钥匙 yàoshi - ключ
КВАРТИРА 床 chuáng - кровать
КВАРТИРА 枕头 zhěntou - подушка
КВАРТИРА 表 biǎo - стол
КВАРТИРА 椅子 yǐzi - стул
КВАРТИРА 扶手椅 fúshǒuyǐ - кресло
КВАРТИРА 冰箱 bīngxiāng - холодильник
КВАРТИРА 沙发 shāfā - диван
КВАРТИРА 镜子 jìngzi - зеркало
ЕДА 食品 shípǐn - ЕДА
ЕДА 面包 miànbāo - хлеб
ЕДА 黄油 huángyóu - масло сливочное 
ЕДА 油 yóu - масло растительное 
ЕДА 起司 qǐsī - сыр
ЕДА 香肠 xiāngcháng - колбаса, сосиска
ЕДА 胡椒粉 hújiāofěn - черный перец
ЕДА 盐 yán - соль
ЕДА 浆果 jiāngguǒ - ягода
ЕДА 蜜糖 mìtáng - мёд
ЕДА 果酱 guǒjiàng - варенье
ЕДА 蘑菇 mógu - гриб
ЕДА 洋葱 yángcōng - лук репчатый 
ЕДА 香蕉 xiāngjiāo - банан
ЕДА 胡萝卜 húluóbo - морковь
ЕДА 梨 lí - груша
ЕДА 甜菜 tiáncài - свекла
ЕДА 水果 shuǐguǒ - фрукты
ЕДА 瓜 guā - дыня
ЕДА 西瓜 xīguā - арбуз
ЕДА 蛋糕 dàngāo - торт
ЕДА 饼 bǐng - пирожок
ЕДА 巧克力 qiǎokèlì - шоколад
ЕДА 肉 ròu - мясо
ЕДА 土豆 tǔdòu - картофель
ЕДА 沙拉 shālā - салат
ЕДА 番茄 fānqié - помидор
ЕДА 黄瓜 huángguā - огурец
ЕДА 卷心菜 juǎnxīncài - капуста
ЕДА 稀饭 xīfàn - каша
ЕДА 汤 tāng - суп
ЕДА 三明治 sānmíngzhì - бутерброд, сэндвич
ЕДА 汽水 qìshuǐ - газировка
ЕДА 水 shuǐ - вода
ЕДА 咖啡 kāfēi - кофе
ЕДА 茶 chá - чай
ЕДА 牛奶 niúnǎi - молоко
ЕДА 果汁 guǒzhī - сок
ЕДА 苹果 píngguǒ - яблоко
ЕДА 葡萄 pútáo - виноград
ЕДА 橙子 chénzi - апельсин
ЕДА 菠萝 bōluó - ананас
ЕДА 杏 xìng - абрикос
ЕДА 糖 táng - сахар
ЕДА 米 mǐ - рис
ЕДА 面条 miàntiáo - лапша
ЕДА 牛肉 niúròu - говядина
ЕДА 猪肉 zhūròu - свинина
ЕДА j鸡 jī - курица
ЕДА 牛扒 niúbā - стейк
ЕДА 柠檬 níngméng - лимон
ЕДА 豌豆 wāndòu - горох
ЕДА 小圆面包 xiǎoyuánmiànbāo - булочка
ЕДА 鱼 yú - рыба
ЕДА 糖果 tángguǒ - конфета
ЕДА 冰淇淋 bīngqílín - мороженое
ЕДА 坚果 jiānguǒ - орех
ЕДА 蛋 dàn - яйцо
ЕДА 桃 táo - персик